18 11

0 7 7 7 7 7 7 7 7 7 7
0 7 7 7 7 7 1 7 7 7 7
2 1 7 7 7 0 0 0 7 7 7
0 0 7 7 7 2 0 0 7 7 7
0 0 7 7 7 0 0 3 7 7 7
0 7 7 7 7 0 0 0 7 7 7
7 7 0 7 7 7 0 7 7 1 7
7 0 0 0 7 7 7 7 7 0 7
7 0 2 0 7 7 7 7 0 0 2
7 0 0 0 7 7 7 7 0 0 0
7 1 3 0 7 1 7 7 0 3 0
7 7 0 7 7 0 7 7 1 0 0
0 7 7 7 0 0 0 7 7 1 7
2 7 7 7 0 2 0 7 7 7 7
0 7 7 7 0 0 3 7 7 7 7
1 7 7 7 7 0 7 7 7 7 7
7 7 7 7 7 1 7 7 7 7 7
