20 10

0 7 7 7 7 7 7 7 7 7
0 7 7 7 7 7 7 7 7 7
0 0 7 7 7 0 7 7 7 7
0 0 7 7 7 0 7 7 7 7
2 0 0 7 0 3 0 7 7 7
0 0 0 7 0 0 0 7 7 7
0 0 0 0 0 0 0 0 7 0
0 1 0 0 0 0 1 0 7 1
0 0 0 0 1 0 0 0 0 0
0 0 0 0 0 0 0 3 1 0
2 0 3 0 0 0 0 0 0 3
0 0 1 0 1 0 0 0 0 0
0 0 0 0 0 0 0 0 7 0
0 0 0 0 0 0 0 0 7 0
0 0 0 7 0 3 0 7 7 7
0 0 0 7 0 0 0 7 7 7
3 0 7 7 7 0 7 7 7 7
0 0 7 7 7 0 7 7 7 7
0 7 7 7 7 7 7 7 7 7
0 7 7 7 7 7 7 7 7 7
